SEASON,equipo,p_jugados,p_ganados,p_empatados,p_perdidos,goles_a_favor,goles_en_contra,diferencia_de_goles,puntos_total
2023-2024,Bayern Munich,6,5,1,0,12,6,6,
2023-2024,FC Copenhagen,6,2,2,2,8,8,0,
2023-2024,Galatasaray,6,1,2,3,10,13,-3,
2023-2024,Manchester Utd,6,1,1,4,12,15,-3,
2023-2024,Arsenal,6,4,1,1,16,4,12,
2023-2024,PSV Eindhoven,6,2,3,1,8,10,-2,
2023-2024,Lens,6,2,2,2,6,11,-5,
2023-2024,Sevilla,6,0,2,4,7,12,-5,
2023-2024,Real Madrid,6,6,0,0,16,7,9,
2023-2024,Napoli,6,3,1,2,10,9,1,
2023-2024,Braga,6,1,1,4,6,12,-6,
2023-2024,Union Berlin,6,0,2,4,6,10,-4,
2023-2024,Real Sociedad,6,3,3,0,7,2,5,
2023-2024,Inter,6,3,3,0,8,5,3,
2023-2024,Benfica,6,1,1,4,7,11,-4,
2023-2024,RB Salzburg,6,1,1,4,4,8,-4,
2023-2024,Atlético Madrid,6,4,2,0,17,6,11,
2023-2024,Lazio,6,3,1,2,7,7,0,
2023-2024,Feyenoord,6,2,0,4,9,10,-1,
2023-2024,Celtic,6,1,1,4,5,15,-10,
2023-2024,Dortmund,6,3,2,1,7,4,3,
2023-2024,Paris S-G,6,2,2,2,9,8,1,
2023-2024,Milan,6,2,2,2,5,8,-3,
2023-2024,Newcastle Utd,6,1,2,3,6,7,-1,
2023-2024,Manchester City,6,6,0,0,18,7,11,
2023-2024,RB Leipzig,6,4,0,2,13,10,3,
2023-2024,Young Boys,6,1,1,4,7,13,-6,
2023-2024,Red Star,6,0,1,5,7,15,-8,
2023-2024,Barcelona,6,4,0,2,12,6,6,
2023-2024,Porto,6,4,0,2,15,8,7,
2023-2024,Shakhtar,6,3,0,3,10,12,-2,
2023-2024,Antwerp,6,1,0,5,6,17,-11,
2016-2017,AS Monaco,6,4,1,1,12,6,6,13.0
2016-2017,Arsenal FC,4,2,1,1,11,7,4,7.0
2016-2017,Atlético Madrid,6,5,1,0,8,2,6,16.0
2016-2017,Bayer Leverkusen,4,1,2,1,7,6,1,5.0
2016-2017,Bayern München,5,4,0,1,16,4,12,12.0
2016-2017,Beşiktaş,3,0,3,0,5,5,0,3.0
2016-2017,Bor. Mönchengladbach,3,0,2,1,3,4,-1,2.0
2016-2017,Borussia Dortmund,5,3,1,1,17,9,8,10.0
2016-2017,CSKA Moskva,3,0,2,1,2,3,-1,2.0
2016-2017,Celtic FC,3,0,1,2,3,7,-4,1.0
2016-2017,Club Brugge KV,3,0,0,3,1,7,-6,0.0
2016-2017,Dinamo Kiev,3,1,0,2,7,4,3,3.0
2016-2017,Dinamo Zagreb,3,0,0,3,0,6,-6,0.0
2016-2017,FC Barcelona,5,4,1,0,21,1,20,13.0
2016-2017,FC Basel,3,0,1,2,3,7,-4,1.0
2016-2017,FC København,3,1,2,0,4,0,4,5.0
2016-2017,FC Porto,4,2,1,1,7,3,4,7.0
2016-2017,FK Rostov,3,1,1,1,5,5,0,4.0
2016-2017,Juventus,7,4,2,1,10,6,4,14.0
2016-2017,Legia Warszawa,3,1,1,1,4,9,-5,4.0
2016-2017,Leicester City,5,4,1,0,7,2,5,13.0
2016-2017,Manchester City,4,3,1,0,13,5,8,10.0
2016-2017,Olympique Lyon,3,1,1,1,3,1,2,4.0
2016-2017,PFC Ludogorets Razgrad,3,0,1,2,3,6,-3,1.0
2016-2017,PSV Eindhoven,3,0,1,2,1,3,-2,1.0
2016-2017,Paris Saint-Germain,4,2,2,0,10,3,7,8.0
2016-2017,Real Madrid,6,5,1,0,19,7,12,16.0
2016-2017,SL Benfica,4,2,1,1,4,3,1,7.0
2016-2017,SSC Napoli,4,1,1,2,7,8,-1,4.0
2016-2017,Sevilla FC,4,3,0,1,8,4,4,9.0
2016-2017,Sporting CP,3,1,0,2,4,4,0,3.0
2016-2017,Tottenham Hotspur,3,1,0,2,4,4,0,3.0
2017-2018,APOEL Nikosia,3,0,1,2,1,10,-9,1.0
2017-2018,AS Monaco,3,0,0,3,2,9,-7,0.0
2017-2018,AS Roma,6,5,1,0,12,2,10,16.0
2017-2018,Atlético Madrid,3,1,1,1,4,3,1,4.0
2017-2018,Bayern München,6,4,1,1,15,3,12,13.0
2017-2018,Beşiktaş,4,1,2,1,5,5,0,5.0
2017-2018,Borussia Dortmund,3,0,1,2,3,6,-3,1.0
2017-2018,CSKA Moskva,3,1,0,2,3,6,-3,3.0
2017-2018,Celtic FC,3,0,0,3,1,8,-7,0.0
2017-2018,Chelsea FC,4,1,3,0,11,5,6,6.0
2017-2018,FC Barcelona,5,5,0,0,15,2,13,15.0
2017-2018,FC Basel,4,2,0,2,7,6,1,6.0
2017-2018,FC Porto,4,2,0,2,9,11,-2,6.0
2017-2018,Feyenoord,3,1,0,2,3,7,-4,3.0
2017-2018,Juventus,5,2,2,1,6,6,0,8.0
2017-2018,Liverpool FC,6,4,2,0,20,4,16,14.0
2017-2018,Manchester City,5,3,0,2,7,5,2,9.0
2017-2018,Manchester United,4,3,0,1,8,3,5,9.0
2017-2018,NK Maribor,3,0,2,1,2,9,-7,2.0
2017-2018,Olympiakos Piraeus,3,0,1,2,2,5,-3,1.0
2017-2018,Paris Saint-Germain,4,3,0,1,16,3,13,9.0
2017-2018,Qarabağ FK,3,0,1,2,1,6,-5,1.0
2017-2018,RB Leipzig,3,1,1,1,5,5,0,4.0
2017-2018,RSC Anderlecht,3,0,0,3,1,9,-8,0.0
2017-2018,Real Madrid,7,4,2,1,16,10,6,14.0
2017-2018,SL Benfica,3,0,0,3,1,5,-4,0.0
2017-2018,SSC Napoli,3,2,0,1,8,5,3,6.0
2017-2018,Sevilla FC,5,2,2,1,9,6,3,8.0
2017-2018,Shakhtar Donetsk,4,4,0,0,9,4,5,12.0
2017-2018,Spartak Moskva,3,1,2,0,7,3,4,5.0
2017-2018,Sporting CP,3,1,1,1,4,3,1,4.0
2017-2018,Tottenham Hotspur,4,3,0,1,10,4,6,9.0
2018-2019,1899 Hoffenheim,3,0,1,2,6,8,-2,1.0
2018-2019,AEK Athen,3,0,0,3,2,7,-5,0.0
2018-2019,AFC Ajax,6,2,2,2,11,9,2,8.0
2018-2019,AS Monaco,3,0,0,3,1,8,-7,0.0
2018-2019,AS Roma,4,3,0,1,10,3,7,9.0
2018-2019,Atlético Madrid,4,4,0,0,9,1,8,12.0
2018-2019,BSC Young Boys,3,1,1,1,3,5,-2,4.0
2018-2019,Bayern München,4,2,1,1,9,5,4,7.0
2018-2019,Borussia Dortmund,4,2,1,1,7,1,6,7.0
2018-2019,CSKA Moskva,3,1,0,2,3,4,-1,3.0
2018-2019,Club Brugge KV,3,0,2,1,1,2,-1,2.0
2018-2019,Crvena Zvezda,3,1,1,1,3,4,-1,4.0
2018-2019,FC Barcelona,6,5,1,0,18,2,16,16.0
2018-2019,FC Porto,5,4,0,1,12,7,5,12.0
2018-2019,FC Schalke 04,4,2,1,1,6,4,2,7.0
2018-2019,Galatasaray,3,1,1,1,5,3,2,4.0
2018-2019,Inter,3,1,2,0,4,3,1,5.0
2018-2019,Juventus,5,3,0,2,9,4,5,9.0
2018-2019,Liverpool FC,6,5,1,0,14,2,12,16.0
2018-2019,Lokomotiv Moskva,3,1,0,2,3,4,-1,3.0
2018-2019,Manchester City,5,4,0,1,20,6,14,12.0
2018-2019,Manchester United,5,1,1,3,1,4,-3,4.0
2018-2019,Olympique Lyon,4,0,4,0,6,6,0,4.0
2018-2019,PSV Eindhoven,3,0,1,2,4,6,-2,1.0
2018-2019,Paris Saint-Germain,4,2,1,1,11,7,4,7.0
2018-2019,Real Madrid,4,2,0,2,6,8,-2,6.0
2018-2019,SL Benfica,3,1,1,1,2,3,-1,4.0
2018-2019,SSC Napoli,3,2,1,0,5,2,3,7.0
2018-2019,Shakhtar Donetsk,3,0,2,1,3,6,-3,2.0
2018-2019,Tottenham Hotspur,7,4,0,3,9,8,1,12.0
2018-2019,Valencia CF,3,2,0,1,5,4,1,6.0
2018-2019,Viktoria Plzeň,3,1,1,1,4,8,-4,4.0
2019-2020,AFC Ajax,3,1,0,2,3,2,1,3.0
2019-2020,Atalanta,5,2,1,2,9,6,3,7.0
2019-2020,Atlético Madrid,4,3,1,0,6,2,4,10.0
2019-2020,Bayer Leverkusen,3,1,0,2,3,5,-2,3.0
2019-2020,Bayern München,4,4,0,0,12,2,10,12.0
2019-2020,Borussia Dortmund,4,3,1,0,7,4,3,10.0
2019-2020,Chelsea FC,4,1,1,2,6,9,-3,4.0
2019-2020,Club Brugge KV,3,0,1,2,1,8,-7,1.0
2019-2020,Crvena Zvezda,3,1,0,2,3,11,-8,3.0
2019-2020,Dinamo Zagreb,3,1,1,1,8,7,1,4.0
2019-2020,FC Barcelona,5,3,1,1,10,11,-1,10.0
2019-2020,Galatasaray,3,0,1,2,1,3,-2,1.0
2019-2020,Inter,3,1,1,1,4,3,1,4.0
2019-2020,Juventus,4,4,0,0,8,2,6,12.0
2019-2020,KRC Genk,3,0,1,2,2,8,-6,1.0
2019-2020,Lille OSC,3,0,1,2,2,5,-3,1.0
2019-2020,Liverpool FC,4,2,1,1,9,8,1,7.0
2019-2020,Lokomotiv Moskva,3,0,0,3,1,6,-5,0.0
2019-2020,Manchester City,5,3,1,1,11,6,5,10.0
2019-2020,Olympiakos Piraeus,3,1,1,1,5,5,0,4.0
2019-2020,Olympique Lyon,5,2,2,1,7,7,0,8.0
2019-2020,Paris Saint-Germain,5,4,0,1,11,1,10,12.0
2019-2020,RB Leipzig,6,3,1,2,9,9,0,10.0
2019-2020,RB Salzburg,3,1,0,2,8,7,1,3.0
2019-2020,Real Madrid,4,1,2,1,11,6,5,5.0
2019-2020,SL Benfica,3,2,0,1,6,3,3,6.0
2019-2020,SSC Napoli,4,2,2,0,8,2,6,8.0
2019-2020,Shakhtar Donetsk,3,0,1,2,2,8,-6,1.0
2019-2020,Slavia Praha,3,0,0,3,2,7,-5,0.0
2019-2020,Tottenham Hotspur,4,2,0,2,11,10,1,6.0
2019-2020,Valencia CF,4,1,1,2,9,10,-1,4.0
2019-2020,Zenit St. Petersburg,3,2,0,1,5,3,2,6.0
2020-2021,AFC Ajax,3,1,0,2,3,3,0,3.0
2020-2021,Atalanta,4,0,2,2,3,9,-6,2.0
2020-2021,Atlético Madrid,4,1,2,1,4,4,0,5.0
2020-2021,Bayern München,5,4,0,1,13,5,8,12.0
2020-2021,Bor. Mönchengladbach,4,1,1,2,8,7,1,4.0
2020-2021,Borussia Dortmund,5,2,2,1,9,5,4,8.0
2020-2021,Chelsea FC,6,3,2,1,8,2,6,11.0
2020-2021,Club Brugge KV,3,1,1,1,4,4,0,4.0
2020-2021,Dinamo Kiev,3,1,0,2,1,6,-5,3.0
2020-2021,FC Barcelona,4,2,0,2,8,9,-1,6.0
2020-2021,FC Midtjylland,3,0,1,2,2,7,-5,1.0
2020-2021,FC Porto,5,3,1,1,7,3,4,10.0
2020-2021,FK Krasnodar,3,1,0,2,2,6,-4,3.0
2020-2021,Ferencvárosi TC,3,0,1,2,3,9,-6,1.0
2020-2021,Inter,3,0,2,1,2,4,-2,2.0
2020-2021,Juventus,4,3,0,1,8,5,3,9.0
2020-2021,Lazio Roma,4,2,1,1,9,8,1,7.0
2020-2021,Liverpool FC,5,3,1,1,5,2,3,10.0
2020-2021,Lokomotiv Moskva,3,0,1,2,3,6,-3,1.0
2020-2021,Manchester City,7,6,0,1,15,3,12,18.0
2020-2021,Manchester United,3,2,0,1,10,4,6,6.0
2020-2021,Olympiakos Piraeus,3,1,0,2,1,3,-2,3.0
2020-2021,Olympique Marseille,3,1,0,2,2,6,-4,3.0
2020-2021,Paris Saint-Germain,6,2,1,3,9,7,2,7.0
2020-2021,RB Leipzig,4,3,0,1,7,5,2,9.0
2020-2021,RB Salzburg,3,0,1,2,4,10,-6,1.0
2020-2021,Real Madrid,6,4,1,1,14,8,6,13.0
2020-2021,Sevilla FC,4,2,0,2,6,9,-3,6.0
2020-2021,Shakhtar Donetsk,3,1,1,1,2,6,-4,4.0
2020-2021,Stade Rennes,3,0,1,2,3,6,-3,1.0
2020-2021,Zenit St. Petersburg,3,0,1,2,3,5,-2,1.0
2020-2021,İstanbul Başakşehir,3,1,0,2,5,7,-2,3.0
2021-2022,AC Milan,3,0,1,2,3,5,-2,1.0
2021-2022,AFC Ajax,4,3,0,1,10,3,7,9.0
2021-2022,Atalanta,3,1,1,1,5,5,0,4.0
2021-2022,Atlético Madrid,5,0,3,2,3,5,-2,3.0
2021-2022,BSC Young Boys,3,1,1,1,6,8,-2,4.0
2021-2022,Bayern München,5,4,1,0,21,4,17,13.0
2021-2022,Beşiktaş,3,0,0,3,3,8,-5,0.0
2021-2022,Borussia Dortmund,3,2,0,1,7,3,4,6.0
2021-2022,Chelsea FC,5,4,0,1,12,3,9,12.0
2021-2022,Club Brugge KV,3,0,1,2,2,11,-9,1.0
2021-2022,Dinamo Kiev,3,0,1,2,1,3,-2,1.0
2021-2022,FC Barcelona,3,1,1,1,1,3,-2,4.0
2021-2022,FC Porto,3,1,0,2,3,8,-5,3.0
2021-2022,FC Sheriff,3,1,0,2,3,6,-3,3.0
2021-2022,Inter,4,2,0,2,5,4,1,6.0
2021-2022,Juventus,4,3,0,1,6,5,1,9.0
2021-2022,Lille OSC,4,1,2,1,2,2,0,5.0
2021-2022,Liverpool FC,7,4,1,2,12,7,5,13.0
2021-2022,Malmö FF,3,0,1,2,1,5,-4,1.0
2021-2022,Manchester City,6,5,1,0,17,8,9,16.0
2021-2022,Manchester United,4,2,1,1,6,5,1,7.0
2021-2022,Paris Saint-Germain,4,4,0,0,10,3,7,12.0
2021-2022,RB Leipzig,3,1,1,1,5,5,0,4.0
2021-2022,RB Salzburg,4,3,1,0,7,3,4,10.0
2021-2022,Real Madrid,6,4,0,2,13,8,5,12.0
2021-2022,SL Benfica,5,2,1,2,8,9,-1,7.0
2021-2022,Sevilla FC,3,1,1,1,4,3,1,4.0
2021-2022,Shakhtar Donetsk,3,0,2,1,1,6,-5,2.0
2021-2022,Sporting CP,4,2,0,2,8,11,-3,6.0
2021-2022,VfL Wolfsburg,3,1,1,1,4,5,-1,4.0
2021-2022,Villarreal CF,6,2,2,2,8,8,0,8.0
2021-2022,Zenit St. Petersburg,3,1,1,1,7,4,3,4.0
2022-2023,AC Milan,6,4,0,2,9,5,4,12.0
2022-2023,AFC Ajax,3,1,0,2,5,9,-4,3.0
2022-2023,AtlÃ©tico de Madrid,3,1,2,0,4,3,1,5.0
2022-2023,Bayer Leverkusen,3,1,1,1,2,3,-1,4.0
2022-2023,Bayern München,5,4,1,0,12,1,11,13.0
2022-2023,Borussia Dortmund,4,2,2,0,5,1,4,8.0
2022-2023,Celtic FC,3,0,1,2,1,6,-5,1.0
2022-2023,Chelsea FC,5,3,1,1,8,4,4,10.0
2022-2023,Club Brugge KV,4,2,0,2,3,6,-3,6.0
2022-2023,Dinamo Zagreb,3,1,1,1,2,5,-3,4.0
2022-2023,Eintracht Frankfurt,4,1,1,2,2,6,-4,4.0
2022-2023,FC Barcelona,3,1,1,1,8,7,1,4.0
2022-2023,FC Copenhagen,3,0,3,0,1,1,0,3.0
2022-2023,FC Porto,4,2,1,1,4,5,-1,7.0
2022-2023,Inter,6,4,1,1,10,5,5,13.0
2022-2023,Juventus,3,1,0,2,5,5,0,3.0
2022-2023,Liverpool FC,4,3,0,1,8,6,2,9.0
2022-2023,Maccabi Haifa,3,1,0,2,4,9,-5,3.0
2022-2023,Manchester City,7,7,0,0,25,2,23,21.0
2022-2023,Olympique Marseille,3,1,0,2,5,4,1,3.0
2022-2023,Paris Saint-Germain,4,2,1,1,10,5,5,7.0
2022-2023,RB Leipzig,4,2,1,1,8,8,0,7.0
2022-2023,RB Salzburg,3,1,1,1,3,3,0,4.0
2022-2023,Rangers,3,0,0,3,2,13,-11,0.0
2022-2023,Real Madrid,6,5,1,0,13,3,10,16.0
2022-2023,SL Benfica,5,3,1,1,12,7,5,10.0
2022-2023,SSC Napoli,5,4,1,0,15,4,11,13.0
2022-2023,Sevilla FC,3,1,0,2,4,8,-4,3.0
2022-2023,Shakhtar Donetsk,3,0,2,1,2,6,-4,2.0
2022-2023,Sporting CP,3,1,0,2,3,4,-1,3.0
2022-2023,Tottenham Hotspur,4,2,2,0,6,3,3,8.0
2022-2023,Viktoria PlzeÅˆ,3,0,0,3,4,10,-6,0.0
